0,0,0,0,0,0,0,0,0,0,0,0,0,0,0,0,0
0,0,0,0,0,0,0,0,0,0,0,0,0,0,0,0,0
0,0,0,0,0,0,0,0,0,0,0,0,0,0,0,0,0
0,0,0,0,0,6,6,6,6,6,6,6,6,6,0,0,0
0,0,0,0,0,6,1,2,2,2,2,2,4,6,0,0,0
0,0,0,0,0,6,6,6,6,6,2,2,3,2,2,4,6
0,0,0,0,0,0,0,0,0,0,0,0,0,0,6,5,6
0,0,0,0,0,0,0,0,0,0,0,0,0,0,6,5,6
0,0,0,0,0,0,0,2,2,2,2,2,2,2,2,3,6
0,0,0,0,0,0,0,0,0,0,0,0,0,0,0,0,0
