0,0,0,0,0,0,0,0,0,0,0,0,0,0,0,0,0
0,0,0,0,0,0,0,0,0,0,0,0,0,0,0,0,0
0,0,0,0,0,0,0,0,0,0,0,0,0,0,0,0,0
0,6,4,4,4,4,4,4,4,4,4,4,4,4,6,6,0
0,6,5,5,5,5,5,5,5,5,5,5,5,3,7,6,0
0,6,5,5,5,5,5,5,5,3,5,3,5,6,6,6,0
0,6,5,5,5,5,5,3,5,6,5,6,5,5,5,6,0
6,1,3,3,3,3,3,6,3,3,3,3,3,3,3,6,0
0,0,0,0,0,0,0,0,0,0,0,0,0,0,0,0,0
0,0,0,0,0,0,0,0,0,0,0,0,0,0,0,0,0
