0,0,0,0,0,0,0,0,0,0,0,0,0,0,0,0,0
0,0,0,0,0,0,0,0,0,0,0,0,0,0,0,0,0
0,0,0,0,0,0,0,0,0,0,0,0,0,0,0,0,0
0,0,0,0,0,0,0,0,0,0,0,0,0,0,0,0,0
0,0,0,0,0,0,0,0,6,4,4,4,6,0,0,0,0
0,0,0,0,6,4,4,4,6,5,5,5,6,0,0,0,0
0,6,4,4,6,5,5,5,6,5,5,5,6,0,0,0,0
6,1,3,3,2,3,3,3,2,3,3,3,7,6,0,0,0
0,0,0,0,0,0,0,0,0,0,0,0,0,0,0,0,0
0,0,0,0,0,0,0,0,0,0,0,0,0,0,0,0,0
